11111111111111111
10000000000000001
10000000000000001
10000000000000001
10000000000000001
10000001100000001
10000000000000001
10000001110000001
10000000000000001
10000000000000001
10000000001100001
10000000000000001
10000000000000001
10000000000000001
10000000000000001
10011000000000001
10000000000000001
10000000000000001
10000000000000001
10000000000000001
10000000000000001
11111111111111111